000000000000000000000000000000000000000000000000000000000000
000000000000000000000000000000000000000000000000000000000000
000000000000000000000000000000000000000000000000000000000000
000000000000000000000000000000000000000000000000000000000000
000000000000000000000000000000000000000000000000000000000000
000000000000000000000000000000000000000000000000000000000000
000000000000000000000000000000000000000000000000000000000000
000000000000000000000000000000000000000000000000000000000000
000000000000000000000000000000000000000000000000000000000000
000000000000000000000000000000000000000000000000000000000000
000000000000000000000000000000000000000000000000000000000000
000000000000001111111000000000000000000000000000000000000000
000000000000001111111100000000000000000000000000000000000000
000000000000011111111100000000000000000000000000000000000000
000000000000011111111110000000000000000000000000000000000000
000000000000111111111110000000000000000000000000000000000000
000000000000111111111111000000000000000000000000000000000000
000000000001111111111111000000000000000000000000000000000000
000000000000111111111111000000000000000000000000000000000000
000000000000111111111110000000000000000000000000000000000000
000000000000011111111110000000000000000000000000000000000000
000000000000011111111100000000000000000000000000000000000000
000000000000001111111100000000000001111111000000000000000000
000000000000001111111000000000000011111111000000000000000000
000000000000000000000000000000000011111111100000000000000000
000000000000000000000000000000000111111111100000000000000000
000000000000000000000000000000000111111111110000000000000000
000000000000000000000000000000001111111111110000000000000000
000000000000000000000000000000001111111111111000000000000000
000000000000000000000000000000001111111111110000000000000000
000000000000000000000000000000000111111111110000000000000000
000000000000000000000000000000000111111111100000000000000000
000000000000000000000000000000000011111111100000000000000000
000000000000000000000000000000000011111111000000000000000000
000000000000000000000000000000000001111111000000000000000000
000000000000001111111000000000000000000000000000000000000000
000000000000001111111100000000000000000000000000000000000000
000000000000011111111100000000000000000000000000000000000000
000000000000011111111110000000000000000000000000000000000000
000000000000111111111110000000111111100000000000000000000000
000000000000111111111111000000111111110000000000000000000000
000000000001111111111111000001111111110000000000000000000000
000000000000111111111111000001111111111000000111111100000000
000000000000111111111110000011111111111000001111111100000000
000000000000011111111110000011111111111100001111111110000000
000000000000011111111100000111111111111100011111111110000000
000000000000001111111100000011111111111100011111111111000000
000000000000001111111000000011111111111000111111111111000000
000000000000000000000000000001111111111000111111111111100000
000000000000000000000000000001111111110000111111111111000000
000000000000000000000000000000111111110000011111111111000000
000000000000000000000000000000111111100000011111111110000000
000000000000000000000000000000000000000000001111111110000000
000000000000000000000000000000000000000000001111111100000000
000000000000000000000000000000000000000000000111111100000000
000000000000000000000000000000000000000000000000000000000000
000000000000000000000000000000000000000000000000000000000000
000000000000000000000000000000000000000000000000000000000000
000000000000000000000000001111111000000000000000000000000000
000000000000000000000000011111111000000000000000000000000000
000000000000000000000000011111111100000000000000000000000000
000000000000000000000000111111111100000000000000000000000000
000000000000000000000000111111111110000000000000000000000000
000000000000000000000001111111111110000000000000000000000000
000000000000000000000001111111111111000000000000000000000000
000000000000000000000001111111111110000000000000000000000000
000000000000000000000000111111111110000000000000000000000000
000000000000000000000000111111111100000000000000000000000000
000000000000000000000000011111111100000000000000000000000000
000000000000000000000000011111111000000000000000000000000000
000000000000000000000000001111111000000000000000000000000000
000000000000000000000000000000000000000000000000000000000000
000000000000000000000000000000000000000000000000000000000000
000000000000000000000000000000000000000000000000000000000000
000000000000000000000000000000000000000000000000000000000000
000000000000000000000000000000000000000000000000000000000000
000000000000000000000000000000000000000000000000000000000000
000000000000000000000000000000000000000000000000000000000000
000000000000000000000000000000000000000000000000000000000000
000000000000000000000000000000000000000000000000000000000000
